###############
#     x@ b o  #
#bb    r    bb#
#bb         bb#
#v            #
# ooooo ooooo #
# o***o o***o #
# or2ao o*2ao #
# ooooo ooooo #
#      b     v#
#             #
#    b    b   #
#####     #####
#*hao  1  oah*#
###############
